1111111111
1000100001
1010101101
1010110101
1000010001
1011011101
1011010001
1001111011
1100000001
1111111111
