1111111111
1000000101
1101111001
1000001011
1011110001
1011110111
1000000001
1101111101
1000000001
1111111111
