1111111111
1000000011
1101111001
1001011111
1100010001
1101110101
1001000101
1011011101
1000000001
1111111111
