1111111111
1000000001
1011011101
1001010101
1101010001
1001011111
1111010001
1001000101
1101010101
1111111111
