1111111111
1011011001
1010001011
1010100011
1010101011
1000101011
1110011001
1011010011
1000010111
1111111111
