1111111111
1000000101
1011111101
1000000001
1111011101
1001000101
1010111101
1011100001
1000001011
1111111111
