1111111111
1001011101
1011000001
1011111101
1010000001
1011101101
1000000101
1011110101
1000000101
1111111111
