1111111111
1101110001
1000001101
1011111101
1010000101
1010111101
1010000001
1011101101
1000000101
1111111111
