1111111111
1010100001
1010011101
1011000001
1000011111
1111010001
1011010101
1000011101
1011000001
1111111111
