1111111111
1000001001
1011101101
1010101001
1010101011
1010101011
1010101001
1010101111
1000100001
1111111111
