1111111111
1000101001
1110100011
1000101001
1101101101
1000001001
1111111011
1001101001
1100001101
1111111111
