1111111111
1010000001
1010111101
1000110101
1010000101
1011111001
1000100011
1110101111
1000100001
1111111111
