1111111111
1000000001
1011010101
1010010101
1011101101
1000101101
1010100001
1010110101
1000000101
1111111111
