1111111111
1000010101
1011000101
1011110001
1000010101
1011000101
1001010101
1011011111
1000000001
1111111111
