1111111111
1000000001
1011111101
1011011101
1001000001
1101111101
1000000101
1111110111
1000000001
1111111111
