1111111111
1000000101
1011110001
1000111011
1110000011
1000111001
1110100011
1010111111
1000000001
1111111111
