1111111111
1000000001
1110111011
1000000001
1011111101
1001000101
1011011101
1011010101
1000000101
1111111111
